LSMap

~~~~~~~~~~~~~~~~~~~~~~~~~~~~~~~~~~~~~~~~~~~~~~~~~~
~~~~~~~ ~~~~~~~~~~~~~~~~~~~            ~~~~~~    !
~              ~~~~~ ~~~~~~ ~~~~~~~~~~        ~~~~
~~~ ~~~~~~~~~~ ~~~~~ ~~~~~~ ~~~~~~~~~~~~~~~~~~~~~~
~~~       ~~~~       ~~~~                   ~~~~~~
~~ ~~~~~~ ~~~~~~~~~~~~~~~~~~~~~~~~~ ~~~~~~~ ~~~~~~
~~ ~~~~~~           ~~~~~~~~~~ ~~~~         ~~~~~~
~         ~~~~~~~~~ ~~~~~~~~~~ ~~~~ ~~~~~~~~~~~~~~
~~~~~~~~~ ~~~~~~~~~          ~ ~~~          ~~~~~~
~~              ~~~~~~~~~~~~ ~~   ~~~ ~~~~~ ~~~~~~
~~ ~~~~~~~~~~~~ ~~ ~~~~~~~~~ ~~~~ ~~~ ~~~~~ ~~~~~~
~~ ~~~ ~~~~~~~~ ~~           ~~~~ ~~~ ~~~~~ ~~~~~~
~~ ~~~ ~~~~~~~~ ~~~~~~~ ~~~~~~~~~ ~~~    ~~ ~~~~~~
~~ ~~~          ~~~~~~~ ~~~~~~~~~ ~~~~~~~~~ ~~~~~~
~~ ~~~ ~~~~ ~~~~~                     ~~~~~ ~~~~~~
~~ ~~~ ~~~~ ~~~~~~~~~~~ ~~~~~~~~~~~~~ ~~~~~ ~~~~~~
~~~~~~ ~~~~        ~~~~ ~~~~~                  ~~~
~~~~~~^~~~~~~~~~~~~~~~~~~~~~~~~~~~~~~~~~~~~~~~~~~~