LSMap

XXXXXXXXXXXXXXXXXXXXX
!~XXX~~~~~~~~~~~~~~~X
X~X~X~X~XXXXX~X~XXX~X
X~X~X~X~~~X~~~X~XX~~X
X~X~XXXXX~XXX~XXXXX~X
X~X~~~~~~~XXXXX~~~~~X
X~XXX~X~XXX~XXXXXXX~X
X~~~~~X~~~~~X~X~~~~~X
X~XXX~XXXXXXX~XXXXX~X
X~~~X~~~~~~~~~XXX~~~X
X~XXXXXXXXXXX~X~X~X~X
X~~XXXX~~XX~~~~~X~X~X
XXXXXXXXXXXXXXXXXXX^X